#############################
#R.......##.##.##.##.......G#
#.#.##.#.##.##.##.##.#.##.#.#
#.#....#.##.......##.#....#.#
#.#.####.##.##.##.##.####.#.#
#.#.........##.##.........#.#
#.###.#.###.##.##.###.#.###.#
#.#...#......#.#......#...#.#
#...#...#.##.....##.#...#...#
#####.###.#..#@#..#.###.#####
#...#...#.##.....##.#...#...#
#.#...#......#.#......#...#.#
#.###.#.###.##.##.###.#.###.#
#.###.......##.##.......###.#
#.####.####.##.##.####.####.#
#.#....####.......####....#.#
#.#.##.####.##.##.####.##.#.#
#B..#....##.##.##.##....#..P#
#############################