####################
#........##........#
#........##........#
#........##........#
#........##........#
#........##........#
#........##........#
#........##........#
#..................#
########.@..########
########....########
#..................#
#........##........#
#........##........#
#........##........#
#........##........#
#........##........#
#........##........#
#........##........#
####################