#####################
#R...#...##.##.....G#
#.#.##.#.##.##.#.##.#
#.#....#.##.##.#.##.#
#.#.####.##.##.#....#
#.#..............##.#
#.###.#.###.####.##.#
#.#...#......#...##.#
#...#...#.##...#....#
#.###.###.#@.###.####
#...#...#.##...#....#
#.#...#......#...##.#
#.###.#.###.####.##.#
#.#..............##.#
#.#.####.##.##.#....#
#.#....#.##.##.#.##.#
#.#.##.#.##.##.#.##.#
#B..#....##.##.....P#
#####################